...........%%%%%%%%%%%%%%%%%
#########...%%%%%%%%%%%%%%%%
........#......%%%%%%%%%%%%%
%%%%%...#..%...............%
%%%%%...#..%..####..........
%%%%%...#..%..#..###########
%%%%%...#..%..#.............
%%%%%...#..%..#.....%%%%%%%%
%%%%%...#.....#....%%%%%%%%%
%%%%%...#######...%%%%%%%%%%
%%%%%...............%%%%%%%%
%%%%%%%%%%..%....%.......%%%