##%######################%##
%##%####################%##%
#%##%##################%##%#
##%##%################%##%##
###%##%##############%##%###
####%##%############%##%####
#####%##%##########%##%#####
######%##%########%##%######
#######%##%######%##%#######
########%##.####.##%########
#########%##.##.##%#########
##########%######%##########