%%%%%%%%%%%%%%%%%%%%%%%%%%%%
........%%%%%%%%%%%%%%%%%%%%
###.###.%%%%%%%%%%%%%%%%%%%%
..#.#.#.%%%%%%%%%%%%%%%%%%%%
%.#.#.#....%%%%%%%%%%%%%%%%%
%.#.#.####.%%%%%%%%%%%%%%%%%
%.#.#....#.%%%%%%%%%%%%.....
%.#.#.%%.#.%%%%.........####
%.#.#.%%.#.%%%%.#########...
%.#.#.%%.#......#.........%%
%.###.%%.########.%%%%%%%%%%
%.....%%..........%%%%%%%%%%