%%%%%%%%%%%%%%%%%%%%%%%%%%%%
%%%%%%%%%%%%%%%%%%%%%%%%%%%%
............................
%%%%%%%%%%%%%%%%%%%%%%%%%%%%
............................
############################
............................
%%%%%%%%%%%%%%%%%%%%%%%%%%%%
............................
%%%%%%%%%%%%%%%%%%%%%%%%%%%%
%%%%%%%%%%%%%%%%%%%%%%%%%%%%
%%%%%%%%%%%%%%%%%%%%%%%%%%%%