%%%%%%%%%%%%%%%%%%%%%%%%%%%%
%%%%%%%%%%%%%%%%%%%%%%%%%%%%
%%%%%%%....%%%%%%%%%%%%%%%%%
#######.###%%%%%%%%%%%%%%%%%
%%%%%%#%#%#%%%%%%%%%%%%%%%%%
%%%%%%#%#.##################
%%%%%%#%#%%%%%%%%%%%%%%%%%%%
%%%%%%#%#%%%%%%%%%%%%%%%%%%%
%%%%%%#.#%%%%%%%%%%%%%%%%%%%
%%%%%%###%%%%%%%%%%%%%%%%%%%
%%%%%%...%%%%%%%%%%%%%%%%%%%
%%%%%%%%%%%%%%%%%%%%%%%%%%%%